1 5 5 5 5 5 5 5 5 5 5 5 5 5 5 5 5 5 5 5 5 5 5 5 5 5 5 5 5 5 5 5 5 5 5 5 5 5 5 5 2 13 13 13 13 13 13 13 13 13 13 13 13 13 13 13 13 13 13 13
6 0 0 0 0 0 0 0 0 0 0 0 0 0 0 0 0 0 0 7 0 0 0 0 0 0 0 0 0 0 0 0 0 0 0 0 0 0 0 0 6 13 13 13 13 13 13 13 13 13 13 13 13 13 13 13 13 13 13 13
6 0 0 0 0 0 0 0 0 0 0 0 0 0 0 0 0 0 0 7 0 0 0 0 0 0 0 0 0 0 0 7 0 0 0 0 0 0 0 0 6 13 13 13 13 13 13 13 13 13 13 13 13 13 13 13 13 13 13 13
6 0 0 0 0 0 0 0 0 0 0 0 0 0 0 0 0 0 0 7 0 0 0 0 0 0 0 0 0 0 0 7 0 0 0 0 0 0 0 0 6 13 13 13 13 13 13 13 13 13 13 13 13 13 13 13 13 13 13 13
6 0 0 0 0 0 0 0 0 0 0 0 0 0 0 0 0 0 0 7 0 0 10 10 10 10 10 10 0 0 0 7 0 0 0 0 0 0 0 0 6 13 13 13 13 13 13 13 13 13 13 13 13 13 13 13 13 13 13 13
6 0 0 0 0 0 0 0 0 0 0 0 0 0 0 0 0 0 0 7 7 7 10 10 10 10 10 10 7 7 7 7 0 0 9 9 9 9 0 0 6 13 13 13 13 13 13 13 13 13 13 13 13 13 13 13 13 13 13 13
6 0 0 9 9 9 9 9 9 0 0 0 9 9 9 9 9 9 0 7 0 0 10 10 10 10 10 10 0 0 0 7 0 0 9 9 9 9 0 0 6 13 13 13 13 13 13 13 13 13 13 13 13 13 13 13 13 13 13 13
6 0 0 9 9 9 9 9 9 0 0 0 9 9 9 9 9 9 0 7 0 0 0 0 0 0 0 0 0 0 0 7 0 0 9 9 9 9 0 0 6 13 13 13 13 13 13 13 13 13 13 13 13 13 13 13 13 13 13 13
6 0 0 8 8 8 8 8 8 0 0 0 8 8 8 8 8 8 0 7 0 0 0 0 0 0 0 0 0 0 0 7 0 0 8 8 8 8 0 0 6 13 13 13 13 13 13 13 13 13 13 13 13 13 13 13 13 13 13 13
6 0 0 8 8 8 8 8 8 0 0 0 8 8 8 8 8 8 0 7 0 0 0 0 0 0 0 0 0 0 0 7 0 0 8 8 8 8 0 0 6 13 13 13 13 13 13 13 13 13 13 13 13 13 13 13 13 13 13 13
6 0 0 8 8 8 8 8 8 0 0 0 8 8 8 8 8 8 0 7 0 0 0 0 0 0 0 0 0 0 0 7 7 7 8 8 8 8 0 0 6 13 13 13 13 13 13 13 13 13 13 13 13 13 13 13 13 13 13 13
6 0 0 8 8 8 12 8 8 0 0 0 8 8 8 8 12 8 0 7 0 0 0 0 0 0 0 0 0 0 0 7 0 0 8 8 8 8 0 0 6 13 13 13 13 13 13 13 13 13 13 13 13 13 13 13 13 13 13 13
6 0 0 0 0 0 7 0 0 0 0 0 0 0 0 0 7 0 0 7 0 0 9 9 9 9 9 9 0 0 0 7 0 0 8 8 8 8 0 0 6 13 13 13 13 13 13 13 13 13 13 13 13 13 13 13 13 13 13 13
6 0 0 0 0 0 7 0 0 0 0 0 0 0 0 0 7 0 0 7 0 0 9 9 9 9 9 9 0 0 0 7 0 0 8 8 12 8 0 0 6 13 13 13 13 13 13 13 13 13 13 13 13 13 13 13 13 13 13 13
6 0 0 7 7 7 7 7 7 7 7 7 7 7 7 7 7 7 7 7 7 7 8 8 8 8 8 8 7 7 7 7 0 0 0 0 7 0 0 0 6 13 13 13 13 13 13 13 13 13 13 13 13 13 13 13 13 13 13 13
6 0 0 0 0 0 0 0 0 0 0 0 0 7 0 0 0 0 0 7 0 0 8 8 8 8 8 8 0 0 0 7 7 7 7 7 7 7 7 7 6 13 13 13 13 13 13 13 13 13 13 13 13 13 13 13 13 13 13 13
6 0 0 0 0 0 0 0 0 0 0 0 0 7 0 0 0 0 0 7 0 0 8 8 8 8 8 8 0 0 0 7 0 0 0 0 0 0 0 0 6 13 13 13 13 13 13 13 13 13 13 13 13 13 13 13 13 13 13 13
6 0 0 0 0 0 0 0 0 0 9 9 9 9 9 9 0 0 0 7 0 0 8 8 8 12 8 8 0 0 0 7 0 0 0 0 0 0 0 0 6 13 13 13 13 13 13 13 13 13 13 13 13 13 13 13 13 13 13 13
6 9 9 9 9 9 9 0 0 0 8 8 8 8 8 8 0 0 0 7 0 0 0 0 0 7 0 0 0 0 0 7 0 0 0 0 0 0 0 0 6 13 13 13 13 13 13 13 13 13 13 13 13 13 13 13 13 13 13 13
6 9 9 9 9 9 9 0 0 0 8 8 8 8 12 8 0 0 0 7 7 7 7 7 7 7 7 7 7 7 7 7 7 7 7 7 7 7 7 7 4 5 5 5 5 5 5 5 5 5 5 5 5 5 5 5 5 5 5 2
6 8 8 8 8 8 8 0 0 0 7 7 7 7 7 7 7 7 7 7 0 0 0 0 11 11 11 11 11 11 9 9 9 0 0 7 0 0 7 0 0 0 0 0 0 0 0 0 0 0 0 0 0 0 0 0 0 0 0 6
6 8 8 8 8 8 8 0 0 0 0 0 0 0 0 0 0 7 0 0 0 0 0 0 11 11 11 11 11 11 9 9 9 0 0 7 0 0 7 0 0 0 0 0 0 0 0 0 0 0 0 0 0 0 0 0 0 0 0 6
6 8 8 8 8 8 8 0 0 0 0 0 0 0 0 0 0 7 0 0 0 0 0 0 11 11 11 11 11 11 8 8 8 0 0 7 0 9 9 9 9 9 9 9 9 9 0 0 0 0 9 9 9 9 0 0 0 0 0 6
6 8 8 8 8 12 8 0 0 0 9 9 9 9 9 9 0 7 0 0 0 0 0 0 11 11 11 11 11 11 8 8 8 0 0 7 0 9 9 9 9 9 9 9 9 9 0 0 0 0 9 9 9 9 0 0 0 0 0 6
6 0 0 0 0 0 0 0 0 0 9 9 9 9 9 9 0 7 0 0 0 0 0 0 11 11 11 11 11 11 8 8 8 0 0 7 0 9 9 9 9 9 9 9 9 9 0 0 0 0 9 9 9 9 0 0 0 0 0 6
6 0 0 0 0 0 0 0 0 0 8 8 8 8 8 8 7 7 0 0 0 0 0 0 11 11 11 11 11 11 8 12 8 0 0 7 0 8 8 8 8 8 8 8 8 8 0 0 0 0 8 8 8 8 0 0 0 0 0 6
6 0 0 0 0 0 0 0 0 0 8 8 8 8 8 8 0 7 0 0 0 0 11 11 11 11 11 11 11 11 7 7 7 7 7 7 0 8 8 8 8 8 8 8 8 8 0 0 0 0 8 8 8 8 0 0 0 0 0 6
6 0 0 0 0 0 0 0 0 0 8 8 8 8 8 8 0 7 0 0 0 0 11 11 11 11 11 11 11 11 11 11 11 0 0 7 0 8 8 8 8 8 8 8 8 8 0 0 0 0 8 8 8 8 0 0 0 0 0 6
6 0 0 0 0 0 0 0 0 0 8 8 8 8 12 8 0 7 0 0 0 0 11 11 11 11 11 11 11 11 11 11 11 0 0 7 0 8 8 8 8 8 8 8 8 8 0 0 0 0 8 8 8 8 0 0 0 0 0 6
6 0 0 0 0 0 0 0 0 0 0 0 0 0 7 0 0 7 0 0 0 0 11 11 11 11 11 11 11 11 11 11 11 0 0 7 0 8 8 8 8 8 8 8 8 8 0 0 0 0 8 8 8 8 0 0 0 0 0 6
6 0 0 0 0 0 0 0 0 0 0 0 0 0 7 7 7 7 0 0 0 0 11 11 11 11 11 11 11 11 11 11 11 0 0 7 0 8 8 8 8 8 8 12 8 8 0 0 0 0 8 8 12 8 0 0 0 0 0 6
6 0 0 0 0 0 0 0 0 0 0 9 9 9 9 0 0 7 0 0 0 0 11 11 11 11 11 11 11 11 11 11 11 0 0 7 0 0 0 0 0 0 0 7 0 0 0 0 0 0 0 0 7 0 0 0 0 0 0 6
6 0 0 9 9 9 9 0 0 0 0 9 9 9 9 0 0 7 0 0 0 0 11 11 11 11 11 11 11 11 11 11 11 0 0 7 7 7 7 7 7 7 7 7 7 7 7 7 7 7 7 7 7 7 7 7 7 7 7 6
6 0 0 9 9 9 9 0 0 0 0 8 8 8 8 7 7 7 0 0 0 0 0 0 0 0 0 0 0 0 11 11 11 0 0 0 0 0 0 7 0 0 0 0 9 9 9 9 9 0 0 0 0 0 0 0 0 0 0 6
6 0 0 8 8 8 8 0 0 0 0 8 8 8 8 0 0 7 0 0 0 9 9 9 9 0 0 0 0 0 0 0 0 0 0 0 0 0 0 7 0 0 0 0 8 8 8 8 8 0 0 0 0 0 0 0 0 0 0 6
6 0 0 8 8 8 8 0 0 0 0 8 8 8 8 0 0 7 7 7 7 8 8 8 8 0 0 0 0 0 0 0 0 0 0 0 0 0 0 7 0 0 0 0 8 8 8 8 8 0 0 0 0 0 0 0 0 0 0 6
6 0 0 8 8 8 8 0 0 0 0 8 8 12 8 0 0 7 0 0 0 8 8 8 8 0 0 0 0 0 0 0 0 0 0 0 0 0 0 7 0 0 0 0 8 8 8 12 8 0 0 0 0 0 0 0 0 0 0 6
6 0 0 8 8 12 8 7 7 7 7 7 7 7 7 7 7 7 0 0 0 0 0 0 0 0 0 0 0 0 0 0 0 0 0 0 0 0 0 7 0 0 0 0 0 0 0 7 0 0 0 0 0 0 0 0 0 0 0 6
6 0 0 0 7 7 7 7 0 0 0 0 0 0 0 0 0 0 0 0 0 0 0 0 0 0 0 0 0 0 0 0 0 0 0 0 0 0 0 7 7 7 7 7 7 7 7 7 7 7 0 0 0 0 0 0 0 0 0 6
4 5 5 5 5 5 5 5 5 5 5 5 5 5 5 5 5 5 5 5 5 5 5 5 5 5 5 5 5 5 5 5 5 5 5 5 5 5 5 5 5 5 5 5 5 5 5 5 5 5 5 5 5 5 5 5 5 5 5 3