1 5 5 5 5 5 5 5 5 5 5 5 5 5 5 5 5 5 5 5 5 5 5 5 5 5 5 5 5 5 5 5 5 5 5 5 5 5 5 5 2 13 13 13 13 13 13 13 13 13 13 13 13 13 13 13 13 13 13 13
6 0 0 0 0 0 0 0 0 0 0 0 0 0 0 0 0 0 0 7 0 0 0 0 0 0 0 0 0 0 0 0 0 0 0 0 0 0 0 0 6 13 13 13 13 13 13 13 13 13 13 13 13 13 13 13 13 13 13 13
6 0 0 0 0 0 0 0 0 0 0 0 0 0 0 0 0 0 0 7 0 0 0 0 0 0 0 0 0 0 0 7 0 0 0 0 0 0 0 0 6 13 13 13 13 13 13 13 13 13 13 13 13 13 13 13 13 13 13 13
6 0 0 0 0 0 0 0 0 0 0 0 0 0 0 0 0 0 0 7 0 0 0 0 0 0 0 0 0 0 0 7 0 0 0 0 0 0 0 0 6 13 13 13 13 13 13 13 13 13 13 13 13 13 13 13 13 13 13 13
6 0 0 0 0 0 0 0 0 0 0 0 0 0 0 0 0 0 0 7 0 14 15 10 10 24 10 10 35 36 0 7 0 0 0 0 0 0 0 0 6 13 13 13 13 13 13 13 13 13 13 13 13 13 13 13 13 13 13 13
6 0 0 0 0 0 0 0 0 0 0 0 0 0 0 0 0 0 0 7 0 16 17 10 25 26 27 10 37 38 0 7 0 0 9 9 9 9 0 0 6 13 13 13 13 13 13 13 13 13 13 13 13 13 13 13 13 13 13 13
6 0 0 9 9 9 9 9 9 0 0 0 9 9 9 9 9 9 0 7 7 18 19 10 28 24 29 10 39 40 7 7 0 0 9 9 9 9 0 0 6 13 13 13 13 13 13 13 13 13 13 13 13 13 13 13 13 13 13 13
6 0 0 9 9 9 9 9 9 0 0 0 9 9 9 9 9 9 0 7 0 20 21 10 30 31 32 10 41 42 0 7 0 0 9 9 9 9 0 0 6 13 13 13 13 13 13 13 13 13 13 13 13 13 13 13 13 13 13 13
6 0 0 8 8 8 8 8 8 0 0 0 8 8 8 8 8 8 0 7 0 22 23 10 10 24 10 10 43 44 0 7 0 0 8 8 8 8 0 0 6 13 13 13 13 13 13 13 13 13 13 13 13 13 13 13 13 13 13 13
6 0 0 8 8 8 8 8 8 0 0 0 8 8 8 8 8 8 0 7 0 0 0 0 0 0 0 0 0 0 0 7 0 0 8 8 8 8 0 0 6 13 13 13 13 13 13 13 13 13 13 13 13 13 13 13 13 13 13 13
6 0 0 8 8 8 8 8 8 0 0 0 8 8 8 8 8 8 0 7 0 0 0 0 0 0 0 0 0 0 0 7 7 7 8 8 8 8 0 0 6 13 13 13 13 13 13 13 13 13 13 13 13 13 13 13 13 13 13 13
6 0 0 8 8 8 12 8 8 0 0 0 8 8 8 8 12 8 0 7 0 0 0 0 0 0 0 0 0 0 0 7 0 0 8 8 8 8 0 0 6 13 13 13 13 13 13 13 13 13 13 13 13 13 13 13 13 13 13 13
6 0 0 0 0 0 7 0 0 0 0 0 0 0 0 0 7 0 0 7 0 0 9 9 9 9 9 9 0 0 0 7 0 0 8 8 8 8 0 0 6 13 13 13 13 13 13 13 13 13 13 13 13 13 13 13 13 13 13 13
6 0 0 0 0 0 7 0 0 0 0 0 0 0 0 0 7 0 0 7 0 0 9 9 9 9 9 9 0 0 0 7 0 0 8 8 12 8 0 0 6 13 13 13 13 13 13 13 13 13 13 13 13 13 13 13 13 13 13 13
6 0 0 7 7 7 7 7 7 7 7 7 7 7 7 7 7 7 7 7 7 7 8 8 8 8 8 8 7 7 7 7 0 0 0 0 7 0 0 0 6 13 13 13 13 13 13 13 13 13 13 13 13 13 13 13 13 13 13 13
6 0 0 0 0 0 0 0 0 0 0 0 0 7 0 0 0 0 0 7 0 0 8 8 8 8 8 8 0 0 0 7 7 7 7 7 7 7 7 7 6 13 13 13 13 13 13 13 13 13 13 13 13 13 13 13 13 13 13 13
6 0 0 0 0 0 0 0 0 0 0 0 0 7 0 0 0 0 0 7 0 0 8 8 8 8 8 8 0 0 0 7 0 0 0 0 0 0 0 0 6 13 13 13 13 13 13 13 13 13 13 13 13 13 13 13 13 13 13 13
6 0 0 0 0 0 0 0 0 0 9 9 9 9 9 9 0 0 0 7 0 0 8 8 8 12 8 8 0 0 0 7 0 0 0 0 0 0 0 0 6 13 13 13 13 13 13 13 13 13 13 13 13 13 13 13 13 13 13 13
6 9 9 9 9 9 9 0 0 0 8 8 8 8 8 8 0 0 0 7 0 0 0 0 0 7 0 0 0 0 0 7 0 0 0 0 0 0 0 0 6 13 13 13 13 13 13 13 13 13 13 13 13 13 13 13 13 13 13 13
6 9 9 9 9 9 9 0 0 0 8 8 8 8 12 8 0 0 0 7 7 7 7 7 7 7 7 7 7 7 7 7 7 7 7 7 7 7 7 7 4 5 5 5 5 5 5 5 5 5 5 5 5 5 5 5 5 5 5 2
6 8 8 8 8 8 8 0 0 0 7 7 7 7 7 7 7 7 7 7 0 0 11 11 11 11 11 11 11 11 9 9 9 0 0 7 0 0 7 0 0 0 0 0 0 0 0 0 0 0 0 0 0 0 0 0 0 0 0 6
6 8 8 8 8 8 8 0 0 0 0 0 0 0 0 0 0 7 0 0 0 0 11 11 11 11 11 11 11 11 9 9 9 0 0 7 0 0 7 0 0 0 0 0 0 0 0 0 0 0 0 0 0 0 0 0 0 0 0 6
6 8 8 8 8 8 8 0 0 0 0 0 0 0 0 0 0 7 0 0 0 0 11 11 11 11 11 11 11 11 8 8 8 0 0 7 0 9 9 9 9 9 9 9 9 9 0 0 0 0 9 9 9 9 0 0 0 0 0 6
6 8 8 8 8 12 8 0 0 0 9 9 9 9 9 9 0 7 0 0 0 0 11 11 11 11 11 11 11 11 8 8 8 0 0 7 0 9 9 9 9 9 9 9 9 9 0 0 0 0 9 9 9 9 0 0 0 0 0 6
6 0 0 0 0 0 0 0 0 0 9 9 9 9 9 9 0 7 0 0 0 0 11 11 11 11 11 11 11 11 8 8 8 0 0 7 0 9 9 9 9 9 9 9 9 9 0 0 0 0 9 9 9 9 0 0 0 0 0 6
6 0 0 0 0 0 0 0 0 0 8 8 8 8 8 8 7 7 0 0 0 11 11 11 11 11 11 11 11 11 8 12 8 0 0 7 0 8 8 8 8 8 8 8 8 8 0 0 0 0 8 8 8 8 0 0 0 0 0 6
6 0 0 0 0 0 0 0 0 0 8 8 8 8 8 8 0 7 0 0 11 11 11 11 11 11 11 11 11 11 7 7 7 7 7 7 0 8 8 8 8 8 8 8 8 8 0 0 0 0 8 8 8 8 0 0 0 0 0 6
6 0 0 0 0 0 0 0 0 0 8 8 8 8 8 8 0 7 0 0 11 11 11 11 11 11 11 11 11 11 11 11 11 0 0 7 0 8 8 8 8 8 8 8 8 8 0 0 0 0 8 8 8 8 0 0 0 0 0 6
6 0 0 0 0 0 0 0 0 0 8 8 8 8 12 8 0 7 0 0 11 11 11 11 11 11 45 46 47 11 11 11 11 0 0 7 0 8 8 8 8 8 8 8 8 8 0 0 0 0 8 8 8 8 0 0 0 0 0 6
6 0 0 0 0 0 0 0 0 0 0 0 0 0 7 0 0 7 0 0 11 11 11 11 11 11 48 49 50 11 11 11 11 0 0 7 0 8 8 8 8 8 8 8 8 8 0 0 0 0 8 8 8 8 0 0 0 0 0 6
6 0 0 0 0 0 0 0 0 0 0 0 0 0 7 7 7 7 0 0 11 11 11 11 11 11 11 11 11 11 11 11 11 0 0 7 0 8 8 8 8 8 8 12 8 8 0 0 0 0 8 8 12 8 0 0 0 0 0 6
6 0 0 0 0 0 0 0 0 0 0 9 9 9 9 0 0 7 0 0 11 11 11 11 11 11 11 11 11 11 11 11 11 0 0 7 0 0 0 0 0 0 0 7 0 0 0 0 0 0 0 0 7 0 0 0 0 0 0 6
6 0 0 9 9 9 9 0 0 0 0 9 9 9 9 0 0 7 0 0 11 11 11 11 11 11 11 11 11 11 11 11 11 0 0 7 7 7 7 7 7 7 7 7 7 7 7 7 7 7 7 7 7 7 7 7 7 7 7 6
6 0 0 9 9 9 9 0 0 0 0 8 8 8 8 7 7 7 0 0 0 0 0 0 0 0 0 11 11 11 11 11 11 0 0 0 0 0 0 7 0 0 0 0 9 9 9 9 9 0 0 0 0 0 0 0 0 0 0 6
6 0 0 8 8 8 8 0 0 0 0 8 8 8 8 0 0 7 0 0 0 9 9 9 9 0 0 0 0 0 0 0 0 0 0 0 0 0 0 7 0 0 0 0 8 8 8 8 8 0 0 0 0 0 0 0 0 0 0 6
6 0 0 8 8 8 8 0 0 0 0 8 8 8 8 0 0 7 7 7 7 8 8 8 8 0 0 0 0 0 0 0 0 0 0 0 0 0 0 7 0 0 0 0 8 8 8 8 8 0 0 0 0 0 0 0 0 0 0 6
6 0 0 8 8 8 8 0 0 0 0 8 8 12 8 0 0 7 0 0 0 8 8 8 8 0 0 0 0 0 0 0 0 0 0 0 0 0 0 7 0 0 0 0 8 8 8 12 8 0 0 0 0 0 0 0 0 0 0 6
6 0 0 8 8 12 8 7 7 7 7 7 7 7 7 7 7 7 0 0 0 0 0 0 0 0 0 0 0 0 0 0 0 0 0 0 0 0 0 7 0 0 0 0 0 0 0 7 0 0 0 0 0 0 0 0 0 0 0 6
6 0 0 0 7 7 7 7 0 0 0 0 0 0 0 0 0 0 0 0 0 0 0 0 0 0 0 0 0 0 0 0 0 0 0 0 0 0 0 7 7 7 7 7 7 7 7 7 7 7 0 0 0 0 0 0 0 0 0 6
4 5 5 5 5 5 5 5 5 5 5 5 5 5 5 5 5 5 5 5 5 5 5 5 5 5 5 5 5 5 5 5 5 5 5 5 5 5 5 5 5 5 5 5 5 5 5 5 5 5 5 5 5 5 5 5 5 5 5 3